AFO	prop	afo
,	punc	,
sexo	n	sexo
feminino	adj	feminino
,	punc	,
81	num	81
anos	n	ano
,	punc	,
filha	n	filho
/	punc	/
cuidadora	n	cuidador
,	punc	,
seguida	v-pcp	seguir
desde	prp	desde
08/2012	num	08/2012
,	punc	,
por	prp	por
demência	n	demência
moderada	v-pcp	moderar
.	punc	.
Filha	prop	filha
desconhecendo	v-ger	desconhecer
plano	n	plano
terapêutico	adj	terapêutico
,	punc	,
referindo	v-ger	referir
agitação	n	agitação
,	punc	,
agressividade	n	agressividade
,	punc	,
incontinência	n	incontinência
esfincteriana	adj	esfincteriana
,	punc	,
necessidade	n	necessidade
de	prp	de
forçar	v-inf	forçar
alimentação	n	alimentação
,	punc	,
uso	n	uso
de	prp	de
«	punc	«
remédio	n	remédio
para	prp	para
os	art	o
nervos	n	nervo
»	punc	»
.	punc	.
Sem	prp	sem
apoio	n	apoio
domiciliário	adj	domiciliário
,	punc	,
recusa	v-fin	recusar
referenciação	n	referenciação
.	punc	.
02/2013	num	02/2013
,	punc	,
doente	adj	doente
acamada	v-pcp	acamadar
,	punc	,
prostrada	v-pcp	prostrar
,	punc	,
úlceras	adj	úlcera
de	prp	de
pressão	n	pressão
,	punc	,
deficiente	adv	deficiente
higiene	n	higiene
,	punc	,
desidratação	n	desidratação
,	punc	,
referenciada	v-pcp	referenciar
á	adv	á
USF	prop	usf
local	adj	local
.	punc	.
