Homem	n	homem
de	prp	de
77	num	77
anos	n	ano
com	prp	com
alterações	n	alteração
mnésicas	adj	mnésica
progressivas	n	progressiva
com	prp	com
dois	num	dois
anos	n	ano
de	prp	de
evolução	n	evolução
e	conj-c	e
crise	n	crise
tónico-clónica	adj	tónico-clónica
generalizada	v-pcp	generalizar
inaugural	adj	inaugural
.	punc	.
A	art	o
investigação	n	investigação
com	prp	com
angio-TAC	n	angio-tac
e	conj-c	e
subsequentemente	n	subsequentemente
angiografia	adj	angiografia
mostrou	v-fin	mostrar
múltiplas	adj	múltipla
fístulas	n	fístula
durais	adj	dural
(	punc	(
seios	n	seio
laterais	adj	lateral
,	punc	,
tórcula	n	tórcula
e	conj-c	e
seio	n	seio
longitudinal	adj	longitudinal
superior	adj	superior
)	punc	)
,	punc	,
com	prp	com
drenagem	n	drenagem
venosa	adj	venoso
retrógrada	v-pcp	retrógradar
para	prp	para
veias	n	veia
corticais	adj	cortical
(	punc	(
Cognard	prop	cognard
2A+B	punc	2a+b
)	punc	)
.	punc	.
Não	adv	não
foi	v-fin	ser
possível	adj	possível
realizar	v-inf	realizar
embolização	n	embolização
por	prp	por
incapacidade	n	incapacidade
de	prp	de
acesso	n	acesso
a	prp	a
o	art	o
ponto	n	ponto
de	prp	de
fístula	n	fístula
.	punc	.
