Mulher	prop	mulher
,	punc	,
32	num	32
anos	n	ano
,	punc	,
síndrome	n	síndrome
depressivo	adj	depressivo
.	punc	.
Epilepsia	prop	epilepsia
mioclónica	v-fin	miar
juvenil	n	juvenil
,	punc	,
início	n	início
a	prp	a
os	art	o
19	num	19
anos	n	ano
,	punc	,
caracterizada	v-pcp	caracterizar
por	prp	por
crises	n	crise
mioclónicas	adj	mioclónica
e	conj-c	e
tónico-clónicas	adj	tónico-clónica
generalizadas	n	generalizada
(	punc	(
TCG	prop	tcg
)	punc	)
,	punc	,
refractária	v-fin	refractárer
a	art	o
LEV	prop	lev
,	punc	,
VPA	prop	vpa
,	punc	,
LTG	prop	ltg
,	punc	,
CLB	prop	clb
,	punc	,
TPM	prop	tpm
.	punc	.
