Homem	n	homem
de	prp	de
49	num	49
anos	n	ano
de	prp	de
idade	n	idade
com	prp	com
antecedentes	n	antecedente
pessoais	adj	pessoal
de	prp	de
quisto	pron-indp	quisto
aracnoideu	v-fin	arar
identificado	v-pcp	identificar
por	prp	por
RMN-CE	prop	rmn-ce
após	prp	após
documentação	n	documentação
por	prp	por
TC-CE	prop	tc-ce
de	prp	de
hipodensidade	n	hipodensidade
cortical	adj	cortical
hemisférica	adj	hemisférica
cerebelosa	adj	cerebelosa
direita	n	direita
em	prp	em
o	art	o
contexto	n	contexto
de	prp	de
cefaleia	n	cefaleia
occipital	adj	occipital
intensa	v-fin	intensar
com	prp	com
uma	art	um
semana	n	semana
de	prp	de
evolução	n	evolução
.	punc	.
Episódios	n	episódio
recorrentes	adj	recorrente
de	prp	de
cefaleias	n	cefaleia
pré-orgásmicas	adj	pré-orgásmica
que	pron-indp	que
cessaram	v-fin	cessar
com	prp	com
a	art	o
abstinência	n	abstinência
sexual	adj	sexual
.	punc	.
