Homem	n	homem
,	punc	,
53	num	53
anos	n	ano
,	punc	,
avaliado	v-pcp	avaliar
por	prp	por
défice	n	défice
sensitivo-	adj	sensitivo-
-motor	n	-motor
de	prp	de
os	art	o
membros	n	membro
inferiores	adj	inferior
e	conj-c	e
hipoestesia	n	hipoestesia
mediana	adj	mediano
direita	n	direita
.	punc	.
Analiticamente	adv	analiticamente
:	punc	:
elevação	n	elevação
de	prp	de
as	art	o
enzimas	n	enzima
hepáticas	adj	hepática
e	conj-c	e
serologias	n	serologia
positivas	adj	positivo
para	prp	para
HBV	prop	hbv
.	punc	.
EMG	prop	emg
/	punc	/
VC	prop	vc
:	punc	:
polineuropatia	n	polineuropatia
axonal	adj	axonal
sensitivo-	v-fin	sensitivar-
-motora	n	-motora
assimétrica	adj	assimétrica
.	punc	.
A	art	o
biópsia	n	biópsia
de	prp	de
nervo	n	nervo
sugeriu	v-fin	sugerir
possível	adj	possível
etiologia	n	etiologia
vascular	adj	vascular
/	punc	/
vasculítica	adj	vasculítica
.	punc	.
Foi	adv	foi
estabelecido	v-pcp	estabelecer
o	art	o
diagnóstico	n	diagnóstico
de	prp	de
poliarterite	n	poliarterite
nodosa	adj	nodoso
.	punc	.
Sob	adj	sob
tenofovir	punc	tenofovir
.	punc	.
