Mulher	prop	mulher
de	prp	de
19	num	19
anos	n	ano
que	pron-indp	que
apresenta	v-fin	apresentar
desde	prp	desde
os	art	o
11	num	11
episódios	n	episódio
de	prp	de
movimentos	n	movimento
involuntários	adj	involuntário
de	prp	de
os	art	o
membros	n	membro
superiores	adj	superior
que	pron-indp	que
são	v-fin	ser
desencadeados	v-pcp	desencadear
por	prp	por
situações	n	situação
de	prp	de
stress	n	stress
e	conj-c	e
movimentos	n	movimento
bruscos	adj	brusco
.	punc	.
A	art	o
mãe	n	mãe
e	conj-c	e
o	art	o
avô	n	avô
paterno	adj	paterno
apresentariam	v-fin	apresentar
movimentos	n	movimento
semelhantes	adj	semelhante
,	punc	,
mas	conj-c	mas
que	pron-indp	que
melhoraram	v-fin	melhorar
significativamente	adv	significativamente
com	prp	com
a	art	o
idade	n	idade
.	punc	.
Foi	v-fin	ser
acompanhada	v-pcp	acompanhar
inicialmente	adv	inicialmente
por	prp	por
a	art	o
psiquiatria	n	psiquiatria
que	pron-indp	que
faz	v-fin	fazer
um	art	um
diagnóstico	n	diagnóstico
inicial	adj	inicial
de	prp	de
tiques	n	tique
.	punc	.
Realizou	v-fin	realizar
estudo	n	estudo
de	prp	de
imagem	n	imagem
que	pron-indp	que
era	v-fin	ser
normal	adj	normal
.	punc	.
Face	prop	face
a	art	o
ausência	n	ausência
de	prp	de
resposta	n	resposta
terapêutica	adj	terapêutica
foi	v-fin	ser
colocada	v-pcp	colocar
como	adv	como
hipótese	n	hipótese
origem	adj	origem
epilética	adj	epilética
tendo	v-ger	ter
sido	v-pcp	ser
medicada	v-pcp	medicar
com	prp	com
ácido	art	ácido
valproico	n	valproico
e	conj-c	e
orientada	v-pcp	orientar
para	prp	para
consulta	n	consulta
de	prp	de
Neurologia	prop	neurologia
.	punc	.
Em	prp	em
Esta	pron-det	este
foi	n	foi
realizado	v-pcp	realizar
EEG	v-fin	eeg
com	prp	com
vídeo	n	vídeo
que	pron-indp	que
identifica	v-fin	identificar
um	art	um
movimento	n	movimento
coreiforme	adj	coreiforme
de	prp	de
o	art	o
membro	n	membro
superior	adj	superior
com	prp	com
duração	n	duração
de	prp	de
alguns	pron-det	algum
segundos	n	segundo
sem	prp	sem
manifestação	n	manifestação
electroencefalográfica	adj	electroencefalográfica
.	punc	.
Foi	v-fin	ser
pedido	v-pcp	pedir
estudo	n	estudo
genético	adj	genético
tendo	v-ger	ter
sido	v-pcp	ser
identificada	v-pcp	identificar
mutação	n	mutação
em	prp	em
o	art	o
gene	n	gene
PRRT2	prop	prrt2
–	punc	–
discinesia	n	discinesia
paroxística	adj	paroxística
cinesigénica	adj	cinesigénica
.	punc	.
