Adolescente	adv	adolescente
de	prp	de
16	num	16
anos	n	ano
com	prp	com
enxaqueca	n	enxaqueca
com	prp	com
aura	n	aura
visual	adj	visual
e	conj-c	e
atrofia	adj	atrofia
cutânea	n	cutânea
linear	adj	linear
fronto-parietal	n	fronto-parietal
direita	adj	direito
.	punc	.
RM	prop	rm
com	prp	com
lesões	n	lesão
parênquimatosas	adj	parênquimatosa
direitas	adj	direito
captantes	n	captante
e	conj-c	e
edema	n	edema
perilesional	adj	perilesional
.	punc	.
