Mulher	prop	mulher
de	prp	de
29	num	29
anos	n	ano
com	prp	com
agravamento	n	agravamento
recente	adj	recente
de	prp	de
cefaleias	n	cefaleia
crónicas	adj	crónica
.	punc	.
Internada	v-pcp	internar
por	prp	por
trombose	n	trombose
venosa	adj	venoso
cerebral	adj	cerebral
.	punc	.
Apresentava	v-fin	apresentar
atrofia	n	atrofia
cutânea	adj	cutânea
e	conj-c	e
óssea	adj	óssea
fronto-parietal	n	fronto-parietal
direita	adj	direito
.	punc	.
A	art	o
RM	prop	rm
revelava	v-fin	revelar
também	adv	também
múltiplas	adj	múltipla
lesões	n	lesão
inflamatórias	adj	inflamatória
bilaterais	adj	bilateral
.	punc	.
