Mulher	prop	mulher
de	prp	de
32	num	32
anos	n	ano
com	prp	com
cefaleia	n	cefaleia
ortostática	adj	ortostática
.	punc	.
RM	prop	rm
cerebral	n	cerebral
sem	prp	sem
alterações	n	alteração
;	punc	;
RM	prop	rm
vertebro-medular	v-inf	vertebrar-medular
com	prp	com
coleção	n	coleção
epidural	adj	epidural
e	conj-c	e
Mielo-TC	prop	mielo-tc
identificando	v-ger	identificar
fístula	n	fístula
cervical	adj	cervical
(	punc	(
C5-C6	prop	c5-c6
)	punc	)
.	punc	.
Recuperação	prop	recuperação
clínica	n	clínica
após	prp	após
o	art	o
terceiro	adj	terceiro
blood	n	blood
patch	adj	patch
lombar	adj	lombar
"	punc	"
cego	adj	cego
"	punc	"
.	punc	.
