Mulher	n	mulher
de	prp	de
40	num	40
anos	n	ano
com	prp	com
cefaleia	n	cefaleia
ortostática	adj	ortostática
.	punc	.
RM	prop	rm
cerebral	n	cerebral
e	conj-c	e
vertebro-medular	v-inf	vertebrar-medular
compatíveis	adj	compatível
com	prp	com
SHIE	prop	shie
,	punc	,
sem	prp	sem
ponto	n	ponto
claro	adj	claro
de	prp	de
fístula	n	fístula
identificado	v-pcp	identificar
em	prp	em
Mielo-RM	prop	mielo-rm
ou	conj-c	ou
Mielo-TC	prop	mielo-tc
.	punc	.
Recuperação	n	recuperação
clínica	adj	clínica
após	prp	após
terceiro	adj	terceiro
blood	n	blood
patch	adj	patch
lombar	adj	lombar
"	punc	"
cego	adj	cego
"	punc	"
com	prp	com
trendelemburg	n	trendelemburg
prolongado	v-pcp	prolongar
.	punc	.
