Lactente	adv	lactente
de	prp	de
quatro	num	quatro
meses	n	mÃªs
,	punc	,
etnia	n	etnia
cigana	adj	cigano
,	punc	,
segundo	prp	segundo
filho	n	filho
de	prp	de
pais	n	pai
consanguíneos	adj	consanguíneo
.	punc	.
Internamento	prop	internamento
em	prp	em
o	art	o
período	n	período
perinatal	adj	perinatal
por	prp	por
má	adj	má
progressão	n	progressão
ponderal	adj	ponderal
.	punc	.
Detectado	v-pcp	detectar
foramen	prp	foramen
ovale	n	ovale
patente	adj	patente
.	punc	.
Reinternamentos	prop	reinternamentos
sucessivos	adj	sucessivo
por	prp	por
infecções	n	infecção
respiratórias	adj	respiratória
com	prp	com
hipoxémia	n	hipoxémia
.	punc	.
A	art	o
O	art	o
exame	n	exame
objectivo	adj	objectivo
salienta	v-fin	salientar
se	pron-pers	se
hipotonia	n	hipotonia
global	adj	global
(	punc	(
sobretudo	adv	sobretudo
axial	adj	axial
)	punc	)
,	punc	,
contacto	n	contacto
visual	adj	visual
pobre	adj	pobre
,	punc	,
múltiplas	adj	múltipla
manchas	n	mancha
mongólicas	adj	mongólica
,	punc	,
hepatoesplenomegália	n	hepatoesplenomegália
e	conj-c	e
hidrocelo	n	hidrocelo
bilateral	adj	bilateral
volumoso	adj	volumoso
.	punc	.
Ecografia	adj	ecografia
transfontanelar	n	transfontanelar
revelou	v-fin	revelar
vasculite	n	vasculite
talâmico-estriada	v-pcp	talâmiquir-estriadar
bilateral	adj	bilateral
.	punc	.
Fundoscopia	prop	fundoscopia
sem	prp	sem
alterações	n	alteração
.	punc	.
Estudo	pron-det	estudo
bioquímico	n	bioquímico
lisossomal	adj	lisossomal
compatível	adj	compatível
com	prp	com
o	art	o
diagnóstico	n	diagnóstico
de	prp	de
gangliosidose	n	gangliosidose
GM1	prop	gm1
.	punc	.
