Relatamos	v-fin	relatar
o	art	o
caso	n	caso
clínico	adj	clínico
de	prp	de
uma	art	um
mulher	n	mulher
de	prp	de
45	num	45
anos	n	ano
de	prp	de
idade	n	idade
,	punc	,
caucasiana	n	caucasiano
,	punc	,
que	pron-indp	que
se	pron-pers	se
apresenta	v-fin	apresentar
em	prp	em
o	art	o
Serviço	prop	serviço
de	prp	de
Urgência	n	urgência
por	prp	por
cefaleia	n	cefaleia
hemicraniana	adj	hemicraniana
direita	n	direita
de	prp	de
instalação	n	instalação
aguda	adj	agudo
em	prp	em
o	art	o
dia	n	dia
anterior	adj	anterior
,	punc	,
de	prp	de
carácter	n	carácter
nevrálgico	adj	nevrálgico
,	punc	,
não	adv	não
correspondendo	v-ger	corresponder
contudo	adv	contudo
a	art	o
dermátomo	adv	dermátomo
específico	adj	específico
,	punc	,
intensidade	n	intensidade
moderada	v-pcp	moderar
,	punc	,
duração	n	duração
de	prp	de
alguns	pron-det	algum
segundos	n	segundo
com	prp	com
múltiplas	n	múltipla
recorrências	adj	recorrência
diárias	adj	diária
e	conj-c	e
não	adv	não
agravada	v-pcp	agravar
por	prp	por
esforços	n	esforço
.	punc	.
Não	adv	não
estava	v-fin	estar
associada	v-pcp	associar
a	prp	a
sintomas	n	sintoma
disautonómicos	adj	disautonómico
ou	conj-c	ou
outros	pron-det	outro
sintomas	n	sintoma
sistémicos	adj	sistémico
.	punc	.
Sem	prp	sem
história	n	história
traumática	adj	traumática
recente	adj	recente
.	punc	.
O	art	o
exame	n	exame
neurológico	adj	neurológico
efectuado	v-pcp	efectuar
não	adv	não
registava	v-fin	registar
quaisquer	pron-det	qualquer
alterações	n	alteração
.	punc	.
Os	art	o
seus	pron-det	seu
antecedentes	n	antecedente
eram	v-fin	ser
relevantes	adj	relevante
para	prp	para
HTA	prop	hta
,	punc	,
DM	prop	dm
tipo	n	tipo
2	num	2
não	adv	não
insulino-tratada	v-pcp	insulinar-tratar
e	conj-c	e
dislipidémia	v-fin	dislipidémer
mista	v-pcp	misturar
.	punc	.
Ainda	adv	ainda
em	prp	em
contexto	n	contexto
de	prp	de
urgência	n	urgência
realizou	v-fin	realizar
estudo	n	estudo
complementar	adj	complementar
com	prp	com
tomografia	n	tomografia
computadorizada	v-pcp	computar
cranioencefálica	v-fin	cranioencefáliquir>
e	conj-c	e
revisão	n	revisão
analítica	adj	analítica
básica	adj	básica
,	punc	,
não	adv	não
revelando	v-ger	revelar
alterações	n	alteração
clinicamente	adv	clinicamente
significativas	adj	significativo
.	punc	.
Teve	v-fin	ter
alta	n	alta
para	prp	para
seguimento	n	seguimento
em	prp	em
regime	n	regime
de	prp	de
ambulatório	n	ambulatório
.	punc	.
Em	prp	em
O	art	o
entanto	n	entanto
,	punc	,
cinco	num	cinco
dias	n	dia
depois	adv	depois
recorre	v-fin	recorrer
novamente	adv	novamente
a	art	o
o	art	o
Serviço	prop	serviço
de	prp	de
Urgência	n	urgência
por	prp	por
manutenção	n	manutenção
de	prp	de
a	art	o
cefaleia	n	cefaleia
com	prp	com
as	art	o
mesmas	pron-det	mesmo
características	n	característica
associando	v-ger	associar
se	pron-pers	se
agora	adv	agora
ligeira	adj	ligeiro
disartria	n	disartria
e	conj-c	e
disfagia	n	disfagia
para	prp	para
sólidos	art	sólido
e	conj-c	e
líquidos	v-pcp	líquidos
.	punc	.
O	art	o
exame	n	exame
neurológico	adj	neurológico
revelava	v-fin	revelar
agora	adv	agora
moderada	v-pcp	moderar
hemiatrofia	n	hemiatrofia
direita	adj	direito
de	prp	de
a	art	o
língua	n	língua
.	punc	.
Nova	adj	novo
revisão	n	revisão
analítica	adj	analítica
com	prp	com
estudo	n	estudo
serológico	adj	serológico
e	conj-c	e
ecografia	n	ecografia
doppler	prp	doppler
carotídeo-vertebral	n	carotídeo-vertebral
foram	v-fin	ser
inconclusivos	adj	inconclusivo
.	punc	.
Realizou	v-fin	realizar
Ressonância	n	ressonância
Magnética	prop	magnética
Cranio-Encefálica	prop	cranio-encefálica
e	conj-c	e
Angio-RM	prop	angio-rm
que	pron-indp	que
revelaram	v-fin	revelar
dissecção	n	dissecção
segmentar	adj	segmentar
carotídea	adj	carotídea
.	punc	.
Iniciou	v-fin	iniciar
terapêutica	n	terapêutica
com	prp	com
heparina	n	heparina
de	prp	de
baixo	adj	baixo
peso	n	peso
molecular	adj	molecular
em	prp	em
doses	n	dose
anticoagulantes	adj	anticoagulante
tendo	v-ger	ter
se	pron-pers	se
verificado	v-pcp	verificar
adequada	v-pcp	adequar
resolução	n	resolução
sintomática	adj	sintomática
.	punc	.
Teve	v-fin	ter
alta	adj	alto
medicada	n	medicada
com	prp	com
terapia	n	terapia
antiagregante	adj	antiagregante
plaquetar	v-inf	plaquetar
.	punc	.
