Homem	n	homem
de	prp	de
26	num	26
anos	n	ano
,	punc	,
observado	v-pcp	observar
em	prp	em
SU	prop	su
por	prp	por
postura	n	postura
distónica	adj	distónica
marcada	v-pcp	marcar
de	prp	de
a	art	o
mão	n	mão
direita	adj	direito
e	conj-c	e
discreta	adj	discreto
fraqueza	n	fraqueza
muscular	adj	muscular
distal	adj	distal
de	prp	de
o	art	o
membro	n	membro
superior	adj	superior
ispilateral	adj	ispilateral
.	punc	.
TAC	prop	tac
CE	prop	ce
identificada	v-pcp	identificar
lesão	n	lesão
hipodensa	adj	hipodensa
subtalâmica	adj	subtalâmica
esquerda	n	esquerda
.	punc	.
